8 40
0000000100000000000000000000000000000000
0000000100111100011111111111000000000000
0000000100000000000000000001000001111111
0000000100000000000000000001000000000000
0011111111111111000000000001111110000000
0000000100000000000000000001000000000000
0000000100000111111100000001000000000000
0000000000000000000000000001000000000000